11111111111111111111
22222222222222222222
33333333333333333333
44444444444444444444
11111111111111111111
22222222222222222222
33333333333333333333
44444444444444444444
00000000000000000000
00000000000000000000
00000000000000000000
00000000000000000000
00000000000000000000
00000000000000000000
00000000000000000000
00000000000000000000
00000000000000000000
00000000000000000000
00000000000000000000
00000000000000000000
