11111111111111111111
11122222222222222111
42222233333333222222
44442200000000224444
44000000000000000044
40000000000000000004
00000000000000000000
00000000000000000000
00000000000000000000
00000000000000000000
00000000000000000000
00000000000000000000
22222222222222222222
44444444444444444444
00000000000000000000
30303030011003030303
00000000000000000000
00000000000000000000
00000000000000000000
00000000000000000000
