14203040000004030241
10243040000004034201
10203440000004430201
14203040000004030241
10243040011004034201
10203440122104430201
14203040011004030241
10243040000004034201
10203440000004430201
14203040333304030241
10243040000004034201
10203440000004430201
10203040000004030201
10203040000004030201
10203040000004030201
10203000000000030201
10200000000000000201
10000000000000000001
00000000000000000000
00000000000000000000
